width 20
height 15
playerPosX 9
playerPosY 9
0 0 0 0 0 0 0 0 0 0 0 0 0 0 0 0 0 0 0 0
0 1 1 1 1 1 1 1 1 1 1 1 2 1 1 1 1 1 1 0
0 1 1 1 1 1 1 1 1 1 1 1 0 1 1 1 4 1 4 0
0 1 3 1 1 1 1 3 1 1 1 1 3 1 1 3 1 1 1 0
0 1 3 1 1 1 1 3 1 1 1 1 3 1 1 1 3 3 3 0
0 1 3 1 1 1 1 3 1 1 1 1 3 1 1 1 1 1 1 0
0 1 3 3 3 3 3 3 1 1 1 1 3 1 1 1 1 1 1 0
0 1 3 1 1 1 1 3 1 1 1 1 3 1 1 1 1 1 1 0
0 1 3 1 1 1 1 3 1 1 1 1 3 1 1 1 1 1 1 0
0 1 3 1 1 1 1 3 1 1 1 1 3 1 1 1 1 1 1 0
0 1 1 1 1 1 1 1 1 1 1 1 1 1 1 1 1 1 1 0
0 1 1 1 1 1 1 1 1 1 1 1 1 1 1 1 1 1 1 0
0 1 1 1 1 1 1 1 1 1 1 1 1 1 1 1 1 1 1 0
0 1 1 1 1 1 1 1 1 1 1 1 1 1 1 1 1 1 1 0
0 0 0 0 0 0 0 0 0 0 0 0 0 0 0 0 0 0 0 0

